{
   "map" : [
    ["w","w","w","w","w","w","w","w","w","w","^","w","w"],
    ["w","c","c","c","w","w","w","w","w","c","c","p","w"],
    ["w","c","c","c","c","c","c","c","c","c","c","c","w"],
    ["w","w","w","w","c","c","w","w","w","w","w","c","w"],
    ["w","w","c","c","c","c","c","w","c","c","c","c","w"],
    ["w","c","c","c","c","c","c","w","c","w","w","c","w"],
    ["w","c","w","w","w","w","w","w","c","w","w","c","w"],
    ["w","m","w","c","c","c","c","c","c","c","c","c","w"],
    ["w","w","w","w","w","w","w","w","w","w","w","w","w"]
  ],

  "player" : {
  	"x" : 11,
  	"y" : 1
  },

  "monster" : {
  	"x" : 1,
  	"y" : 7
  },

  "door" : {
    "x" : 10,
    "y" : 0
  }
}
