{
   "map" : [
    ["w","w","w","w","w","w","w","w","w","w","^","w","w"],
    ["w","p","c","c","c","c","c","c","c","c","c","c","w"],
    ["w","c","w","w","c","w","w","w","w","w","w","c","w"],
    ["w","c","w","w","c","c","w","w","w","w","w","c","w"],
    ["w","c","c","c","c","c","c","w","c","c","c","c","w"],
    ["w","c","c","c","c","c","c","w","c","w","w","c","w"],
    ["w","c","w","w","w","w","w","w","c","w","w","c","w"],
    ["w","c","w","c","c","c","c","c","c","c","c","m","w"],
    ["w","w","w","w","w","w","w","w","w","w","w","w","w"]
  ],

  "player" : {
    "x" : 1,
    "y" : 1
  },

  "monster" : {
    "x" : 11,
    "y" : 7
  },

  "door" : {
    "x" : 10,
    "y" : 0
  }
}